--------------------------------
--------------------------------
---------------------XXXX-------
-------------XXX----------------
----------------------XX--------
------XX------------------------
---------------------------X----
----------XX--------------------
----------------------XXXX------
----P-------------------------G-
--------------------------------
XXXXXXXXXXXXXXXXXXXXXXXXXXXXXXXX
