--------------------------------
--------------------------------
-----------------XX-------------
-----------------XX-------------
---------------XXXXX------------
------------------------------G-
---------XX---------------------
-----XX-------------------------
--P-----------------------------
--------------------------------
--------------------------------
XXXXXXXXXXXXXXXXXXXXXXXXXXXXXXXX
